UUUUUUUUUUUUUUUUUUUUUU
UM   FU FFFF    R L JU
U  U FU  G     UUUXUUU
U  U FU    K   U  J  U
UUEU    FFF    G     U
UA      UUUU       K U
UL      N  U   UUUUUUU
U  U  UUU  UUGUU    EU
U  U   K   U      A  U
U KU UUUU     FF     U
U  ULU  U    UUUUU   U
U  UUU  U J UU RU    U
U            U  U   RU
UK FFFF FF   UG UF   U
U  UUU  UUUUU   U  FFU
U   RU J        UA   U
UUUUUU  UUU UUUUUUUU U
U   U  K   K         U
U L UN      UUUUUXF FU
U   UUXUUU  U  GUKUGUU
U N      U  U   UNUBUU
U   F        R CUUUTPU
UUUUUUUUUUUUUUUUUUUUTU
